6
1
2 4 2 3 a
c 2 0 0 0 b
c 4 1 4 0 c
c 5 3 5 1 d
c 3 2 1 2 e
c 0 5 0 4 f
c 3 5 1 5 g
o 5 5